21 30
u u u u u u u u u u u u u u u u u u u u u u u u u u u u u u
u u u u u u u u u u u u u u u u u u u u u u u u u u u u u u
u u u u u u u u u u u u u u u u u u u u u u u u u u u u u u
u u u u u u u u u u u u u u u u u u u u u u u u u u u u u u
u u u u u u u u u u u u u u u u u u u u u u u u u u u u u u
u u u u u u u u u u u u u u u u u u u u u u u u u u u u u u
u u u u u u u u u u u u u u u u u u u u u u u u u u u u u u
u u u u u u u u u u u u u u u u u u u u u u u u u u u u u u
u u u u u u u u u u u u u u u u u u u u u u u u u u u u u u
u u u u u u u u u u u u u u u u u u u u u u u u u u u u u u
u u u u u u u u u u u u u u u u u u u u u u u u u u u u u u
u u u u u u u u u u u u u u u u u u u u u u u u u u u u u u
u u u u u u u u u u u u u u u u u u u u u u u u u u u u u u
u u u u u u u u u u u u u u u u u u u u u u u u u u u u u u
u u u u u u u u u u u u u u u u u u u u u u u u u u u u u u
p p p p p p p p p p p p p p p p p p p p p p p p p p p p p p
a d y d a y y d y a y a y d y y a y y d a y a y d a d y a y
y a y y d a y a y d a d y a y a y y y d y a y y a y a y d a
y y d a y y d y y y y d y y y a d y d a y y d y a y a y d y
a y y y d y a y y a y a y d a y a y y d a y a y d a d y a y
s s s s s s s s s s s s s s s s s s s s s s s s s s s s s s