20 15
u u u u u u u u u u u u u u u
u u u u u u u u u u u u u u u
u u u u u u u u u u u u u u u
q q u u u u u u u u u u u u u
w w u u u u u u u u u u u u u
u e p p p p p h u u u u u u u
u r a a a a a j u u u u u u u
u r a a a a a j u u u u u u u
u r a a a a a j u u u u u u u
u r a a a a a j u u u u u u u
u r a a a a a j u u u u u u u
u t s s s s s k u u u u u u u
u u u u u u u u u u u u u u u
u u u u u u u u u u u u u u u
u u u u u u u u u u u u u u u
u u u u u u u u u u u u u u u
u u u u u u u u u u u u u u u
u u u u u u u u u u u u u u u
u u u u u u u u u u u u u u u
u u u u u u u u u u u u u u u